#########################################
0                                       #
####################################### #
#                                       #
####################################### #
#                                       #
#                                       #
#                                       #
#                                       #
#                                       #
#######################################F#
