#########################################
F                                       #
####################################### #
#                                       #
####################################### #
#                                       #
#                                       #
#                                       #
#                                       #
#                                       #
#                                       #
#######################################0#
