  #################################################
      #   #       #       #       #         #     #
# ##### # ### ### ####### # # # # # ### # ####### #
#       #       #   #       # # #     # # # #     #
##### # ### # # # ### ####### ### # ### ### ##### #
#   # # #   # # #   #     #   #   #   # #   #     #
# # ### # ### ######### ### ### ##### # # # ##### #
# #     # #       # #   #   #     #   # # # #     #
# ### ### ##### ### ### # # ### ##### ### ####### #
# # # # #     #   #   # # # # # #   #             #
# # ### # ########### ##### # # # # ###############
# #       F           # #     # # # #       #     #
# ##################### ####### # # ### ### ### # #
#       # #   #   #       #   #   # #     #     # #
# # ### # ### # # # # # # # # # ####### ### ##### #
# # #     # #   #   # # #   #   #       # # # #   #
### # ### # ####### ### # # ######### ### ### ### #
#   # #           # #   # # #     # #   # # #   # #
### ####### ### ### ####### # ##### # ### # # #####
#       #     #       #     #   #         # #     #
# # ####### ##### # # # ##### # ##### ### # # # # #
# #       #     # # # #       #     # #     # # # #
### ####### # # # ##### ### ### # ### ######### ###
# # #   #   # # # #   # #   # # #       #         #
# ##### ##### ##### # # # ### ### ####### #########
#     #   # # #     # # #   #   #   #       # # # #
### # ### # # ##### # ### ### ########### ### # # #
# # # #     # # #   # #   # #               #     #
# # # # ### # # # # # ### # # # ####### # ### #####
#   # # #   #   # # #         # #       #   #     #
# # # # ##### # # ##### ### # # # ####### ### ### #
# # # #     # # #   #   #   # # # #       # #   # #
# ### # ######### ### # # ##### # ####### # ##### #
# # #   # #       # # # # #     # #   # #         #
### ### # ### # # # # ### ### ##### ### ##### ### #
# #   #   #   # # #   #   #     # #     #       # #
# # # # ### ########### ######### ### # # ### ### #
# # #             #   #     #         # # #   #   #
# ######### ##### ### ##### # ##### # ### # ##### #
#   #           #   #0            # #   # #   #   #
# # # ##### ######### # ##### # # # ##### ##### ###
# #   # #     # #   # # #   # # # # #   # #   #   #
##### # ### # # # ##### ### ####### # ##### # # # #
#   # #     # #       #       #     # #   # #   # #
### ### # ### # ### # ##### ##### ### ### ### #####
# #   # # #   # # # # # # # #         #   #     # #
# # # # ######### ### # # ##### ####### # ### ### #
#   #     #   # # # #   #             # #         #
# ### # ##### # # # # ### ### ####### ### ### #####
# #   #             #     #       #   #     #      
###################################################
