  XXXXXXXXXXXXXXXXXXXXXXXXXXXXXXXXXXXXXXXXXXXXXXXXX
      X   X       X       X       X         X     X
X XXXXX X XXX XXX XXXXXXX X X X X X XXX X XXXXXXX X
X       X       X   X       X X X     X X X X     X
XXXXX X XXX X X X XXX XXXXXXX XXX X XXX XXX XXXXX X
X   X X X   X X X   X     X   X   X   X X   X     X
X X XXX X XXX XXXXXXXXX XXX XXX XXXXX X X X XXXXX X
X X     X X       X X   X   X     X   X X X X     X
X XXX XXX XXXXX XXX XXX X X XXX XXXXX XXX XXXXXXX X
X X X X X     X   X   X X X X X X   X             X
X X XXX X XXXXXXXXXXX XXXXX X X X X XXXXXXXXXXXXXXX
X X       F           X X     X X X X       X     X
X XXXXXXXXXXXXXXXXXXXXX XXXXXXX X X XXX XXX XXX X X
X       X X   X   X       X   X   X X     X     X X
X X XXX X XXX X X X X X X X X X XXXXXXX XXX XXXXX X
X X X     X X   X   X X X   X   X       X X X X   X
XXX X XXX X XXXXXXX XXX X X XXXXXXXXX XXX XXX XXX X
X   X X           X X   X X X     X X   X X X   X X
XXX XXXXXXX XXX XXX XXXXXXX X XXXXX X XXX X X XXXXX
X       X     X       X     X   X         X X     X
X X XXXXXXX XXXXX X X X XXXXX X XXXXX XXX X X X X X
X X       X     X X X X       X     X X     X X X X
XXX XXXXXXX X X X XXXXX XXX XXX X XXX XXXXXXXXX XXX
X X X   X   X X X X   X X   X X X       X         X
X XXXXX XXXXX XXXXX X X X XXX XXX XXXXXXX XXXXXXXXX
X     X   X X X     X X X   X   X   X       X X X X
XXX X XXX X X XXXXX X XXX XXX XXXXXXXXXXX XXX X X X
X X X X     X X X   X X   X X               X     X
X X X X XXX X X X X X XXX X X X XXXXXXX X XXX XXXXX
X   X X X   X   X X X         X X       X   X     X
X X X X XXXXX X X XXXXX XXX X X X XXXXXXX XXX XXX X
X X X X     X X X   X   X   X X X X       X X   X X
X XXX X XXXXXXXXX XXX X X XXXXX X XXXXXXX X XXXXX X
X X X   X X       X X X X X     X X   X X         X
XXX XXX X XXX X X X X XXX XXX XXXXX XXX XXXXX XXX X
X X   X   X   X X X   X   X     X X     X       X X
X X X X XXX XXXXXXXXXXX XXXXXXXXX XXX X X XXX XXX X
X X X             X   X     X         X X X   X   X
X XXXXXXXXX XXXXX XXX XXXXX X XXXXX X XXX X XXXXX X
X   X           X   X0            X X   X X   X   X
X X X XXXXX XXXXXXXXX X XXXXX X X X XXXXX XXXXX XXX
X X   X X     X X   X X X   X X X X X   X X   X   X
XXXXX X XXX X X X XXXXX XXX XXXXXXX X XXXXX X X X X
X   X X     X X       X       X     X X   X X   X X
XXX XXX X XXX X XXX X XXXXX XXXXX XXX XXX XXX XXXXX
X X   X X X   X X X X X X X X         X   X     X X
X X X X XXXXXXXXX XXX X X XXXXX XXXXXXX X XXX XXX X
X   X     X   X X X X   X             X X         X
X XXX X XXXXX X X X X XXX XXX XXXXXXX XXX XXX XXXXX
X X   X             X     X       X   X     X      
XXXXXXXXXXXXXXXXXXXXXXXXXXXXXXXXXXXXXXXXXXXXXXXXXXX
