########################################################################################################################################################
0              #     #           #              #  #  #     #        #     #        #        #                 #     #                                #
#  #######  #  ####  #######  #######  #######  #  #  #  #  #  ####  #  ####  #######  ####  ####  #  ####  #  ####  ####  ####  ################  #  #
#     #     #  #     #           #           #  #  #  #  #  #  #           #  #        #           #     #  #           #     #  #  #     #     #  #  #
#######  ##########  #  #  ####  #  #  ####  ####  #  #  ####  #######  #  #  #  #  #########################  #  ####  ####  ####  #  #######  ####  #
#  #              #  #  #  #  #  #  #  #  #  #                 #     #  #  #     #     #                       #  #  #              #  #  #        #  #
#  #  ####  #  ####  #######  #  #######  #  #  #  ##########  #  #########################  #  #  ####  #  ####  #  #  ##########  #  #  #  ####  ####
#        #  #              #     #     #  #  #  #        #     #  #        #  #  #           #  #  #     #  #  #  #  #           #     #     #  #  #  #
#  #######  #  #  #  #  ####  ####  ####  #  #  ####  #  ####  #  #######  #  #  ####  ####  #  ##########  #  ####  #######  ####  ####  ####  #  #  #
#        #  #  #  #  #  #              #     #     #  #     #              #  #           #  #        #           #        #     #  #        #     #  #
#######  #######  ####  #  #  #  #######  #  #  ####  ####  ####  #######  #  ################  ####  ####  #  ####  ##########  #######  ##########  #
#     #     #     #        #  #        #  #        #     #     #  #  #        #  #  #  #  #     #  #  #     #     #                 #  #     #     #  #
#  #######  #############  #######  ####  #  ##########  ##########  #  ####  #  #  #  #  #  #  #  #  ####  #  ##########  ####  ####  #  #  #  ####  #
#  #        #     #  #  #  #              #  #        #     #     #        #  #        #     #     #  #     #  #        #  #        #  #  #  #  #     #
#  ####  #  ####  #  #  #  #  #  ##########  #  #############  ####  #######  #  #######  #############  #  #######  ##########  ####  #  #  #  ####  #
#     #  #  #              #  #  #     #  #  #              #     #  #  #  #        #           #        #     #              #  #        #  #  #     #
#  #  #  ####  ####  #############  ####  #  #######  #######  #######  #  #  #  #############  ####  ##########  #######  #  #  #  #######  #  #  ####
#  #     #     #  #  #  #     #        #     #        #  #        #  #     #  #     #  #     #     #           #     #     #  #        #              #
#  #  #  #  ####  ####  #  #  ####  ####  ####  #  #  #  #  #######  #  #  ####  #  #  ####  ####  ####  #  #######  #  #  #  ###################  #  #
#  #  #  #     #           #  #     #  #     #  #  #  #  #     #  #     #  #     #  #     #  #     #  #  #           #  #  #     #  #     #        #  #
######################  #  #  ####  #  #  ##########  #  #  ####  #  #  ##########  #  #  #  #  #  #  ####  ####  ################  #  #############  #
#     #  #  #  #     #  #  #  #     #        #     #  #     #     #  #  #  #     #     #     #  #  #     #  #              #  #  #                 #  #
####  #  #  #  ####  #  #  ####  ##########  ####  #  #  ####  #  #  ####  #  ####  ####  #  #  #  #  #  ##########  #######  #  #  #  #######  #  ####
#     #        #  #     #  #           #           #           #  #  #        #     #     #  #  #     #           #        #  #  #  #     #     #  #  #
#  ####  #  ####  #  ####  #  #######  #  #######  ####  ##########  #######  #  #############  #  ######################  #  #  #######  #  ####  #  #
#        #     #     #  #     #  #        #           #     #  #        #     #           #     #  #     #        #     #        #  #     #  #  #     #
#  #  ##########  #  #  #######  #  ####  #  ####  ####  #  #  #  ####  ####  #  ##########  ####  ####  #  #  #######  ##########  #######  #  #  #  #
#  #     #  #  #  #           #     #     #  #           #     #  #                 #           #  #        #     #  #  #     #  #  #        #  #  #  #
#  #######  #  #  #######  ####  ####  #  ####  ####  ############################  #  #  ####  #######  ##########  #  ####  #  #  ####  ####  #######
#           #  #  #  #     #        #  #  #  #  #  #        #  #     #  #     #        #  #        #     #        #     #     #        #              #
####  ####  #  #  #  ####  ##########  ####  ####  #######  #  #  ####  #  #  #  #  #  #######  #######  #######  #  #######  #  ####  #  #  ##########
#        #  #        #        #              #     #        #           #  #     #  #        #           #        #     #  #  #  #        #  #  #     #
####  #######  #######  ####  #############  #  #######  #  ####  ################  #######  ####  #######  #######  ####  #  #######  ####  #  ####  #
#  #        #  #        #              #              #  #  #           #  #           #        #     #  #                 #     #  #     #           #
#  #  ##########  ####  #  #  ##########  ####  ####  ##########  #  ####  ####  ####  ##########  ####  ##########  ####  ####  #  #  ####  #  ####  #
#  #     #        #  #  #  #  #              #     #           #  #  #  #  #     #  #  #     #  #  #  #  #           #  #  #              #  #     #  #
#  #  #######  ####  #  #  #  ####  #  #############  #  #######  ####  #  ####  #  #  ####  #  #  #  #  #######  ####  #  #  #######  #  ####  ####  #
#              #        #  #  #  #  #  #  #  #     #  #     #        #              #  #     #  #     #  #     #     #           #  #  #  #        #  #
#######  #  #  ##########  ####  #  ####  #  ####  #  #  #######  #######  #######  ####  ####  #######  #  ####  #############  #  ####  #############
#  #  #  #  #  #           #  #  #        #           #  #  #           #     #  #           #  #  #  #  #        #        #     #        #     #     #
#  #  ##########  ##########  #  ##########  ####  #######  #######  #  #  ####  #  ##########  #  #  #  #  ##########  ####  ####  ####  #  #  #  #  #
#     #              #           #  #           #     #  #  #        #     #  #  #     #              #              #  #  #     #     #     #     #  #
#  ##########  #######  #  #  ####  ####  ##########  #  #  ####  #  #######  #  #######  #######  ####  #######  #  #  #  #  #  ####  #  #############
#           #           #  #        #     #           #        #  #  #        #  #           #     #     #  #     #  #     #  #  #     #     #        #
##########  #  ####  #######  #  ####  #  ##########  #######  ####  #  ####  #  ####  #  ####  #  #  #  #  #  ####  ####  ##########  ####  #  #######
#     #        #  #        #  #  #  #  #  #        #  #           #        #  #  #     #  #     #     #     #     #  #                 #     #  #     #
####  #  ####  #  #  ####  #######  #  ##########  #######  ####  ####  #  #  #  #  #  #  #############  #######  #  #############  #  #######  #  #  #
#           #  #     #     #     #        #        #        #        #  #  #     #  #  #           #        #     #  #  #           #        #  #  #  #
#  ####  ####  #  ##########  ####  #######  ####  #  #  ######################  #  ####  #  ####  ###################  ################  ####  ####  #
#  #  #     #  #     #  #           #  #        #     #  #        #        #     #     #  #  #           #  #           #  #     #                    #
#  #  #######  #######  ##########  #  ####  #######  ##########  ####  ####  #######  ####  #  ####  #  #  #  #  #######  ####  #  ####  ####  ####  #
#           #        #     #        #     #  #  #        #     #     #                    #  #     #  #  #     #  #     #     #  #  #  #  #     #     #
#  ####  #  ####  ####  #  #  ####  ####  ####  ####  ####  ####  ####  #  ###################  #######  #  ##########  #  ####  #  #  #######  #  #  #
#  #  #  #  #  #     #  #  #     #  #  #     #              #        #  #  #  #  #  #  #           #     #           #           #        #  #  #  #  #
#  #  #  #  #  #  #######  #  #######  ####  #  #############  #######  ####  #  #  #  #  ####  #  ##########  #  #######  #  #  #######  #  #######  #
#  #     #     #  #        #        #        #  #  #  #  #           #     #  #  #        #  #  #  #     #     #     #     #  #           #     #  #  #
#  ####  #############  #  ####  #  #  #######  #  #  #  ####  #######  ####  #  #  #######  #######  #############  #  ####  ####  ####  ####  #  #  #
#  #  #  #           #  #     #  #  #        #     #                          #        #  #     #        #  #     #     #     #  #     #     #     #  #
#  #  #  #######  #######  #######  ####  ####  ####  ####  ################  ##########  ####  ####  #  #  #  #######  #######  ##########  ####  #  #
#  #        #                    #  #        #     #  #  #              #     #     #        #     #  #  #  #                 #        #  #        #  #
#  #######  #  ####  #  #  #######  ####  #  #  #  #  #  #########################  #######  ####  ####  #  ####  #  #  ##########  #  #  ####  ####  #
#     #     #  #     #  #     #           #  #  #  #  #        #  #  #        #  #  #  #           #              #  #  #        #  #  #        #     #
#######  ##########  ####  #  #  ####  ##########  #  #  #######  #  ####  #  #  #  #  #######  #############  #######  ####  #######  #  #  ####  #  #
#  #  #  #     #     #     #  #     #  #  #                          #  #  #  #     #  #     #     #  #     #        #           #        #     #  #  #
#  #  #  ####  #############  #  #  #  #  #  ####  #  #######  ####  #  ####  #  ####  #  ####  ####  ####  #  #######  ####  #  #######  #  ##########
#  #              #     #        #  #  #  #     #  #  #           #     #        #  #     #     #        #        #  #     #  #  #     #  #  #        #
#  #  #  ####  ####  ##########  #  ####  #  ###############################  ####  ####  ####  #  #  #  ####  #  #  #######  ####  #  #  #  #  #######
#     #     #     #  #           #     #     #  #  #           #  #                 #  #  #     #  #  #  #     #           #     #  #  #  #  #        #
#############  ####  #  #######  ####  ####  #  #  #######  ####  #  #############  #  #  #  ##########  ####  #######  #######  #  #######  #  #######
#  #  #  #        #  #  #     #  #        #  #     #     #        #  #     #  #        #           #        #        #     #     #        #     #  #  #
#  #  #  ####  #  #  ####  #######  ####  ####  ####  #######  #######  #  #  #  ##########  #  #######  ####  ####  #############  #  ####  ####  #  #
#     #     #  #  #     #  #     #  #  #  #     #     #        #     #  #  #        #        #  #           #     #     #     #     #           #  #  #
#  ####  #  ####  ####  #  #  #  ####  #  ####  #  ####  #  #  ####  ####  #######  #  ####  #######  #  ####  #######  ####  ####  #############  #  #
#     #  #     #  #     #  #  #              #           #  #  #     #     #  #     #  #           #  #        #     #  #        #  #                 #
####  #  ####  #######  #  ####  #  #  #  ####  #  #############  #######  #  ####  #  ##########  #  ##########  #  ####  #######  #  ##########  #  #
#           #        #           #  #  #  #     #                       #  #     #     #        #     #     #     #  #     #  #     #  #     #     #  #
#  #  #######  #  ##########  #######  #######  #  ####  #  ##########  #  ####  #  #  #  ##########  ####  #  #######  ####  ####  #  #  #######  #  #
#  #  #        #  #  #     #        #  #  #     #  #  #  #        #        #        #     #     #  #           #           #  #  #        #     #  #  #
#  #  #  ####  ####  #  ####  #######  #  ####  ####  ####  ####  ################  #  #  #  ####  #######  #######  #  ####  #  ####  #######  #  #  #
#  #  #  #     #           #        #     #        #  #     #  #  #        #        #  #     #     #           #     #  #  #              #     #  #  #
#  #  #  #######  ##########  ####  #  ##########  #  ####  #  #  #  #######  ####  #######  #  ##########  #  #######  #  #  #######  #######  #  ####
#  #  #           #     #  #     #  #     #        #     #     #     #  #  #  #     #  #        #  #        #  #              #        #     #     #  #
#  #######  ####  ####  #  #######  #######  #######  #######  #######  #  #  #  #  #  #  ####  #  ##########  ##########  ####  ####  #  #######  #  #
#     #     #           #           #           #  #           #     #     #  #  #  #     #     #  #  #  #        #  #  #  #  #  #     #     #  #     #
####  ####  #############  #  ####  ####  #######  ####  ##########  #  ####  #  #  #######  ####  #  #  ####  ####  #  ####  ####  #######  #  #######
#        #              #  #  #  #  #           #           #     #  #     #  #  #  #     #     #  #     #  #     #     #     #  #              #  #  #
#  #######  #  ####  ##########  #  ####  #############  #  #  ####  #  #  #  ####  #  #######  #  #  ####  ####  ####  #  ####  ##########  #  #  #  #
#  #        #  #     #        #     #                 #  #     #  #     #        #     #  #     #     #           #           #        #  #  #     #  #
#  #######  ####  #######  ####  ##########  #  ##########  ####  ####  #  #  ####  ####  ####  #  ####  ##########  ####  ####  ####  #  #######  #  #
#  #        #        #                    #  #  #     #           #     #  #     #     #              #  #        #  #           #              #  #  #
#######  #############  #  ####  #  ##########  #  #  ####  #######  #####################################  #  #  #  ####  #  ######################  #
#        #     #  #  #  #     #  #        #     #  #  #           #  #  #     #     #                    #  #  #  #  #  #  #  #  #           #        #
####  #  ####  #  #  #  ####  #  #  #######  #  #  ####  ##########  #  ####  ####  ##########  #  ##########  #######  #  ####  ##########  #######  #
#     #  #                 #  #  #     #     #  #  #  #     #     #     #  #              #     #  #              #                 #     #     #     #
#######  ##########  #  #  #  #  ####  #  ####  #  #  #  ####  #######  #  #  #  #  ####  #  #  ####  ################  #############  ####  ####  ####
#  #  #              #  #  #  #  #  #  #  #  #  #  #        #                 #  #     #  #  #     #     #                 #                 #     #  #
#  #  ####  #  #######  #######  #  #  #  #  #  #  #  ####  ##########  ####  #  #  ####  #  #  ####  #  #  #  #######  #######  ##########  #  ####  #
#        #  #     #        #     #     #  #  #  #     #     #  #        #     #  #  #        #        #     #     #           #        #     #        #
#  ####  #  ####  ###################  ####  ####  #######  #  ##########  ####  ##########  #######  #  ####  #############  #  ####  #  #  #######  #
#  #        #     #                             #        #                    #        #        #     #  #                 #     #     #  #           #
####################################################################################################################################################F##
