#######################################################################################################################################################
F     #                 #  #           #  #  #        #        #  #                       #              #              #        #                 #  #
####  #  #######  #  ####  ####  ####  #  #  #  #  #  #  #  #  #  #  ####  #############  #  #######  #  ####  #  ####  #  #######  ##########  ####  #
#     #     #  #  #  #           #           #  #  #     #  #  #  #  #        #                 #     #  #  #  #  #     #  #  #        #        #  #  #
#  #  #  ####  #######  #  #  ##########  ####  ################  #  #  ####  #############  #  #######  #  #######  ####  #  ####  #  ####  ####  #  #
#  #           #  #  #  #  #     #     #     #              #  #  #  #     #        #  #     #     #           #  #  #              #     #  #     #  #
#  #  #######  #  #  ####  #  ####  ################  #######  #  ####  ####  #  ####  ####  #######  #  ####  #  #  ####  ####  ##########  #  #  #  #
#  #  #        #        #  #        #        #        #  #              #  #  #     #        #        #     #        #     #              #  #  #     #
#  ####  ####  #  #######  #  #  ####  #  #  #  #  #  #  #  #############  ##########  ###################  ####  ####  #######  #  #  #  ##########  #
#     #     #           #  #  #  #     #  #     #  #  #  #     #                 #     #     #  #  #  #  #     #     #  #        #  #  #  #     #     #
#  ####  ####  #######  ####  ####  ####  #  ####  ####  #  ####  ###################  #  ####  #  #  #  ####  ####  #  #######  ####  #######  #  #  #
#     #  #  #  #        #  #           #  #     #     #  #  #  #     #  #     #     #  #     #     #  #     #     #  #        #     #     #        #  #
##########  ####  #  #  #  #  #  #######  #############  #  #  #  ####  #  #######  ####  #  #  ####  #  ####  #######  ##########  ##########  ####  #
#  #  #           #  #     #  #     #  #        #           #                 #  #  #     #  #  #     #     #                 #     #              #  #
#  #  ####  #############  ##########  ####  #######  #  ####  #  ####  #######  #  ####  #  #  #  #  ####  #######  #  #######  #  #############  #  #
#     #  #  #  #           #  #              #        #  #  #  #  #  #  #     #           #        #           #     #  #     #  #     #        #  #  #
#  ####  #  #  ####  #######  ##########  ####  #  #######  #  ####  ####  #######  ################  #  #  ####  ####  #  #######  ####  #  #######  #
#           #     #              #              #           #        #        #     #     #        #  #  #  #  #     #  #  #              #  #  #     #
#######  ####  ####  ##########  #######  #######  #############  #  #  #  #######  #  #######  ####  #  #  #  ####  #  #  #  ################  #  #  #
#  #        #        #           #           #  #           #  #  #     #                    #  #  #  #  #     #     #  #  #           #           #  #
#  ##########  #######  ####  ####  #  ####  #  ####  #######  #  #######  ################  #  #  #  ####  #  #  ####  #  #  ####  ################  #
#  #     #     #     #     #        #     #     #  #     #              #  #        #        #     #  #     #  #  #        #  #     #  #           #  #
#  #  #  ####  #  #  #  ##########  #######  #  #  ####  ##########  ####  ####  #  ####  #######  #######  #  #  #  #  #######  ####  #######  ####  #
#     #  #        #  #  #  #     #  #     #  #        #  #        #     #  #  #  #        #     #           #     #  #  #  #  #           #     #     #
#  #######  ####  #######  ####  #######  ####  #############  #  ####  #  #  #  ####  ####  ####  #  #  #  #  #######  #  #  #  ####  #######  ####  #
#           #                    #  #           #        #  #  #  #     #  #     #  #     #        #  #  #  #  #     #        #     #  #     #        #
####  ##########  #######  ####  #  #######  #  #  #######  #  ################  #  #  ###################  #  ####  #  ####  #  ##########  #  ####  #
#           #        #     #              #  #           #     #        #     #     #  #     #           #  #  #     #     #  #  #     #  #  #  #  #  #
#  #######  #  #  ####  #  ##########  #############  ####  ####  #  #  #  ####  ##########  #  ##########  ####  #  ####  ####  ####  #  #  #  #  #  #
#        #  #  #     #  #        #  #  #        #  #  #     #     #  #           #  #  #              #           #  #        #  #  #           #  #  #
####  #  #############  ####  #  #  #  #######  #  #  #  ####  ##########  ####  #  #  ####  #######  #######  #  #  #  ##########  #  #  #  ####  ####
#     #  #  #     #  #  #     #     #     #              #  #  #  #        #  #     #  #        #  #     #     #  #  #  #  #           #  #  #     #  #
#  ####  #  ####  #  #  ####  ####  ####  #######  #  #  #  ####  #  #######  #######  #######  #  #######  #######  #  #  #  ####  #######  ####  #  #
#     #     #        #     #  #  #  #  #  #        #  #  #  #  #                 #        #     #  #           #     #           #  #     #        #  #
####  ####  ####  ####  ####  #  ####  ####  ##########  #  #  ####  #######  ####  #######  ####  #############  #######  #  ##########  #  ####  #  #
#     #              #     #        #  #           #        #        #  #     #              #           #     #  #  #  #  #     #        #  #        #
####  #######  #  #  ##########  ####  ################  #  ##########  #######  #  #  ####  #  #############  #  #  #  #  #  #######  #  ####  ####  #
#     #     #  #  #           #           #  #        #  #  #  #     #  #  #  #  #  #  #        #  #     #     #  #        #        #  #        #     #
####  #  #######  #############  ####  ####  #######  #  #  #  ####  #  #  #  ####  #  ##########  #  #######  ####  #######  ####  ####  #######  ####
#  #  #           #     #     #     #  #           #     #     #        #  #     #  #  #  #  #  #     #  #     #        #     #        #        #     #
#  #  #  ####  #  #  ####  #############  #  #  #######  #  #  #  #######  #  ####  ####  #  #  #  #  #  #  #######  #############  ####  #############
#     #     #  #  #        #  #           #  #     #  #  #  #     #     #        #  #           #  #           #  #     #     #        #              #
####  ################  #  #  #######  ##########  #  #  ####  #######  #  #######  ####  #######  #######  ####  ####  ####  ####  #######  #  ####  #
#        #        #     #     #     #  #           #     #  #                 #           #  #  #        #  #     #  #           #  #  #  #  #     #  #
#  #  #  #  #  #  #  #######  ####  ####  #  #######  ####  ####  ####  ####  #  ####  ####  #  ##########  #  ####  #  #  #  ####  #  #  ####  ####  #
#  #  #     #  #  #     #              #  #  #                 #  #     #  #  #  #     #  #     #     #           #     #  #  #     #     #     #  #  #
####  #######  #############  ##########  ####  ####  #  ################  #  #######  #  #  #  #  #  #######  ####  ################  #  #  #  #  ####
#  #     #        #  #     #              #     #     #     #  #           #  #     #  #     #  #  #  #  #     #        #  #  #  #     #     #     #  #
#  #  #  ##########  #  ####  #  ##########  #  ####  #######  #######  ##########  #  #  ####  ####  #  #  #  #  ####  #  #  #  #############  ####  #
#     #        #              #        #     #     #        #  #           #        #  #     #     #  #  #  #  #  #  #     #  #           #           #
#  ####  #  ##########  #  #######  #######  ####  ##########  #  ####  ####  #######  ##########  #  #  ####  #  #  #######  ####  ####  #######  ####
#     #  #     #        #  #  #     #  #        #     #              #           #  #  #  #        #           #                 #  #     #     #     #
################  ##########  ####  #  ####  ####  #######  ##########  ##########  #  #  #  #  ####  #  ##########  #######  ##########  #  ####  ####
#  #              #           #     #  #  #  #                 #     #  #     #     #     #  #        #           #  #  #        #     #           #  #
#  ####  #  #  ####  #  #  #  ####  #  #  ####  #######  ####  #  #######  #  ####  #  ####  ##########  #  ####  ####  #  #  ####  #  ####  #  ####  #
#  #     #  #  #     #  #  #  #              #  #     #  #     #  #        #  #           #  #           #  #  #  #        #  #     #  #     #  #     #
#  #  #  #  #  ####  ####  #  #############  #  #  #############  #  #  #######  #######  ##########  ####  #  ################  #  ##########  #  #  #
#     #  #  #           #  #  #           #        #     #           #     #  #  #     #           #  #           #        #     #  #              #  #
#  ####  ####  ################  #######  #  ####  #  #  ################  #  #  #  #  #  #  ####  ####  #  #############  #  ####  #############  #  #
#  #  #     #  #  #        #  #  #     #  #  #     #  #     #  #        #     #  #  #     #  #     #  #  #           #  #  #  #           #     #  #  #
#  #  #######  #  #  #  ####  #  ####  ##########  #######  #  ####  #  ####  #######  #  #  #######  ####  ####  ####  #  #  ####  #  #  #  ####  ####
#     #     #  #     #           #     #  #     #              #     #           #     #  #  #        #        #  #     #     #     #  #  #           #
#  #######  #  ####  #######  #######  #  ####  #  #######  #  #######  ####  #  ####  ##########  ####  ##########  #######  ####  ####  #######  #  #
#     #     #  #        #              #        #     #     #  #     #     #  #  #              #        #     #              #  #  #     #        #  #
#  #######  #  #  #  #######  ##########  ####  #######  #  #######  #  ####  #  ##########  ####  ####  #  #  ####  ##########  #  #  ##########  ####
#  #  #  #        #     #  #     #        #  #     #  #  #  #  #  #     #  #  #  #  #     #  #     #        #  #  #  #  #     #     #     #        #  #
####  #  ##########  #  #  #  #######  ####  #  ####  #  ####  #  ####  #  #  ####  #  #  #  ##########  #######  ####  #  ####  ################  #  #
#        #           #     #     #  #  #     #  #  #        #  #        #  #     #  #  #        #        #  #  #  #     #     #  #                 #  #
#  #  ####  #  ####  ##########  #  #  ####  #  #  #  #  #  #  ####  ####  #######  ####  ####  #######  #  #  #  #  #  #  #  #  #  ####  #  #  ####  #
#  #  #     #  #  #  #     #     #        #     #  #  #  #     #              #        #  #     #                    #  #  #           #  #  #        #
#  #############  #  ####  #  #######  #######  #  #######  #  #  ####  #  #  #######  #  ####  ####  #  ##########  ####  ####  ################  ####
#     #           #        #     #  #  #  #  #     #  #     #  #     #  #  #     #  #  #     #  #     #        #     #  #  #        #              #  #
#  ####  #######  ####  ####  ####  #  #  #  #  ####  #######  ####  #  ####  ####  #  #  #############  #  ##########  #  #  #  #######  ####  #  #  #
#           #     #        #     #        #     #  #           #  #  #  #  #                 #     #     #     #  #        #  #  #     #  #  #  #  #  #
#  ####  #######  ####  #  #######  ####  #######  ####  #  ####  #  ####  ##########  ##########  #######  ####  #  #  ####  #  #  #  ####  #  #  #  #
#  #  #  #        #     #  #        #     #     #  #  #  #           #     #              #  #           #     #     #  #     #  #  #  #  #     #     #
####  ####  ####  #  ##########  #  #  #  #  ####  #  #  ####  ####  #  #  #  #  #  ####  #  #  #######  #  #  #############  ####  #  #  ##########  #
#     #  #  #                    #  #  #  #        #        #  #     #  #  #  #  #     #              #     #           #  #     #  #  #     #        #
#  ####  #######  #  #  #######  ################  ####  ################  #  #  #  #  #############  ##########  ####  #  #  #######  ####  ##########
#     #     #     #  #  #  #        #     #        #  #  #     #     #        #  #  #           #              #  #        #  #     #  #     #        #
####  #  ####  ##########  ####  #######  #######  #  ####  #  ####  ####  #  #######  #  ####  ####  #  ##########  ##########  #  #  ####  #######  #
#     #     #  #  #  #  #        #  #              #     #  #        #  #  #     #     #     #     #  #  #                 #  #  #  #                 #
#  #  ####  ####  #  #  #  #######  ####  ##########  #  ####  #######  ####  #  ##########  ####  ##########  #############  ####  #  #  ####  #  ####
#  #  #              #              #     #  #     #  #     #                 #  #  #        #     #                 #  #     #     #  #  #     #     #
#  ####  #  ####  #  #  #  ####  ####  ####  ####  #  ##########  ####  #######  #  ####  ####  ##########  #######  #  ####  #  #  #  #######  #  ####
#  #     #  #     #  #  #     #  #     #        #           #     #     #  #     #     #  #           #     #     #        #     #  #  #        #  #  #
#  #  #############  #  #######  #  #  #  #############  ####  ##########  ####  ####  #  ######################  #######  #  #  #  #############  #  #
#        #        #  #  #           #        #     #  #     #     #  #  #  #  #     #  #        #        #     #        #  #  #  #           #        #
#######  #  #  #######  ##########  #  ##########  #  #  #  #  #  #  #  #  #  #######  #  #  #######  #######  #######  #  ####  #######  ####  ####  #
#           #  #           #        #           #        #  #  #     #           #        #  #     #     #     #  #                 #           #     #
##########  #  ##########  #  #############  #######  #######  #######  ####  #######  #######  ####  #######  #  #######  #  #############  #  #######
#     #  #  #        #     #  #     #     #     #     #        #  #  #     #  #        #                    #        #     #  #        #     #        #
#  #  #  #  ##########  ##########  ####  #  #######  #######  #  #  #  ####  ####  ####  ####  #######  #  ####  ####  #  #  #######  #  #  #  #######
#  #        #              #     #  #  #              #  #     #        #     #        #     #  #     #  #  #        #  #  #  #     #  #  #  #     #  #
##########  #  #  #######  #  #  #  #  ####  #######  #  #######  #  ####  ####  #  #############  #######  #  #######  #  ####  #  #  #  #######  #  #
#  #           #     #        #  #                 #  #  #     #  #  #  #        #     #        #  #     #              #        #  #  #  #  #  #     #
#  ################  #######  ####  #  #############  #  #  #  ####  #  #  #############  #  ####  #  #  ##########  ####  #######  #  #  #  #  #  #  #
#           #        #  #  #  #     #        #              #  #  #     #        #  #  #  #        #  #        #        #  #  #  #     #        #  #  #
##########  #  #  #  #  #  #  #############  ####  #  ##########  #  #######  ####  #  ##########  ####  #  #######  #######  #  #  #######  #  #######
#              #  #        #           #        #  #  #                    #                    #        #                    #        #     #        #
####################################################################################################################################################0##
