#########################################
0                                       #
####################################### #
#                                       #
####################################### #
#                                       #
#                                       #
#                                       #
#                                       #
#                                      ##
#######################################F#
