#########################################
                                        #
####################################### #
#                                       #
####################################### #
#                                       #
#                                       #
#                                       #
#                                       #
#                                       #
#######################################F#
